{"horiz_walls":[
  [0,1,1,1,1,1,1,1,1,1,1,1,1,1,1,0],
  [0,0,0,0,0,0,1,1,1,1,1,1,0,1,0,0],
  [0,0,1,1,1,0,0,0,0,0,0,0,1,0,1,0],
  [0,1,1,1,0,0,0,0,0,0,0,1,0,1,0,0],
  [1,1,0,0,1,0,0,1,1,1,1,0,1,0,0,0],
  [0,0,0,1,0,0,0,0,0,1,0,1,1,1,0,0],
  [0,0,0,1,0,0,1,1,1,0,1,1,0,0,0,0],
  [0,0,1,0,1,0,0,0,0,0,1,0,0,0,0,0],
  [0,1,0,1,0,0,0,1,1,1,0,1,0,0,0,0],
  [1,0,1,0,0,0,0,1,1,1,1,0,0,0,0,0],
  [1,0,1,0,0,0,1,1,1,1,1,1,0,1,0,0],
  [1,0,1,0,0,0,1,1,1,1,0,0,1,0,1,0],
  [1,0,1,0,0,1,0,0,0,0,0,0,0,1,0,0],
  [0,1,1,1,1,0,1,0,1,1,1,0,1,0,0,0],
  [0,0,0,0,0,0,1,1,1,1,1,0,1,0,0,0]],

  "n":16,"target":[[8,8],[7,7],[7,8],[8,7]],

  "vert_walls":[
    [0,0,0,0,0,0,0,0,0,0,0,0,0,0,0],
    [1,0,1,0,1,0,0,0,0,0,0,0,0,0,1],
    [0,1,0,1,0,1,1,0,1,0,1,0,1,0,1],
    [1,0,0,0,1,1,0,1,0,1,0,1,0,1,1],
    [0,0,1,0,1,1,1,0,1,0,1,0,1,0,1],
    [0,1,1,0,1,1,0,1,0,0,1,0,0,1,1],
    [1,1,0,0,1,1,1,0,1,0,0,0,0,1,1],
    [1,0,1,0,1,1,1,0,1,0,0,0,1,1,1],
    [1,1,0,1,1,1,0,0,1,1,0,1,1,1,1],
    [0,0,1,0,1,1,0,0,0,0,0,1,1,1,1],
    [0,0,1,1,1,1,0,0,0,0,0,0,1,0,1],
    [0,0,1,1,1,0,0,0,0,0,0,1,1,0,1],
    [0,0,1,1,1,1,0,1,1,0,1,0,1,0,1],
    [0,0,0,1,0,0,0,0,0,1,0,1,0,1,1],
    [0,1,0,1,0,1,0,0,0,0,0,0,0,1,1],
    [1,0,1,0,1,0,0,0,0,0,0,0,0,1,0]]}
